n i e n e
i e n n i
s n e e i
n n i n i
i n e f n