f n n e i
n n e i n
i e n n e
n n n e i
n e i s n