s n i e n
e n e n i
f n i e e
n n e n i
n e i i n